1111111111 1111111111 1111111111 1111111111 1111111111 1111111111 1111111111 1111111112
3111111111 1111111111 1111111111 1111111111 1111111111 1111111111 1111111111 1111111110 
1111111111 1111111111 1111111111 1111111111 1111111111 1111111111 1111111111 1111111112 
3111111111 1111111111 1111111111 1111111111 1111111111 1111111111 1111111111 1111111110 
1111111111 1111111111 1111111111 1111111111 1111111111 1111111111 1111111111 1111111112
3111111111 1111111111 1111111111 1111111111 1111111111 1111111111 1111111111 1111111110 
1111111111 1111111111 1111111111 1111111111 1111111111 1111111111 1111111111 1111111112
3111111111 1111111111 1111111111 1111111111 1111111111 1111111111 1111111111 1111111110 
1111111111 1111111111 1111111111 1111111111 1111111111 1111111111 1111111111 1111111112
3111111111 1111111111 1111111111 1111111111 1111111111 1111111111 1111111111 1111111110 
1111111111 1111111111 1111111111 1111111111 1111111111 1111111111 1111111111 1111111112
3111111111 1111111111 1111111111 1111111111 1111111111 1111111111 1111111111 1111111110 
1111111111 1111111111 1111111111 1111111111 1111111111 1111111111 1111111111 1111111112
3111111111 1111111111 1111111111 1111111111 1111111111 1111111111 1111111111 1111111110 
1111111111 1111111111 1111111111 1111111111 1111111111 1111111111 1111111111 1111111112
3111111111 1111111111 1111111111 1111111111 1111111111 1111111111 1111111111 1111111110 
1111111111 1111111111 1111111111 1111111111 1111111111 1111111111 1111111111 1111111112
3111111111 1111111111 1111111111 1111111111 1111111111 1111111111 1111111111 1111111110 
1111111111 1111111111 1111111111 1111111111 1111111111 1111111111 1111111111 1111111112
3111111111 1111111111 1111111111 1111111111 1111111111 1111111111 1111111111 1111111110 
1111111111 1111111111 1111111111 1111111111 1111111111 1111111111 1111111111 1111111112
3111111111 1111111111 1111111111 1111111111 1111111111 1111111111 1111111111 1111111110 
1111111111 1111111111 1111111111 1111111111 1111111111 1111111111 1111111111 1111111112
3111111111 1111111111 1111111111 1111111111 1111111111 1111111111 1111111111 1111111110 
1111111111 1111111111 1111111111 1111111111 1111111111 1111111111 1111111111 1111111112
3111111111 1111111111 1111111111 1111111111 1111111111 1111111111 1111111111 1111111110 
1111111111 1111111111 1111111111 1111111111 1111111111 1111111111 1111111111 1111111112 
3111111111 1111111111 1111111111 1111111111 1111111111 1111111111 1111111111 1111111110 
1111111111 1111111111 1111111111 1111111111 1111111111 1111111111 1111111111 1111111112
3111111111 1111111111 1111111111 1111111111 1111111111 1111111111 1111111111 1111111110 
1111111111 1111111111 1111111111 1111111111 1111111111 1111111111 1111111111 1111111112
3111111111 1111111111 1111111111 1111111111 1111111111 1111111111 1111111111 1111111110 
1111111111 1111111111 1111111111 1111111111 1111111111 1111111111 1111111111 1111111112
3111111111 1111111111 1111111111 1111111111 1111111111 1111111111 1111111111 1111111110 
1111111111 1111111111 1111111111 1111111111 1111111111 1111111111 1111111111 1111111112
3111111111 1111111111 1111111111 1111111111 1111111111 1111111111 1111111111 1111111110 
1111111111 1111111111 1111111111 1111111111 1111111111 1111111111 1111111111 1111111112
3111111111 1111111111 1111111111 1111111111 1111111111 1111111111 1111111111 1111111110 
1111111111 1111111111 1111111111 1111111111 1111111111 1111111111 1111111111 1111111112
3111111111 1111111111 1111111111 1111111111 1111111111 1111111111 1111111111 1111111110 
1111111111 1111111111 1111111111 1111111111 1111111111 1111111111 1111111111 1111111112
3111111111 1111111111 1111111111 1111111111 1111111111 1111111111 1111111111 1111111110 
1111111111 1111111111 1111111111 1111111111 1111111111 1111111111 1111111111 1111111112
3111111111 1111111111 1111111111 1111111111 1111111111 1111111111 1111111111 1111111110 
1111111111 1111111111 1111111111 1111111111 1111111111 1111111111 1111111111 1111111112
3111111111 1111111111 1111111111 1111111111 1111111111 1111111111 1111111111 1111111110 
1111111111 1111111111 1111111111 1111111111 1111111111 1111111111 1111111111 1111111112
3111111111 1111111111 1111111111 1111111111 1111111111 1111111111 1111111111 1111111110 
1111111111 1111111111 1111111111 1111111111 1111111111 1111111111 1111111111 1111111112
3111111111 1111111111 1111111111 1111111111 1111111111 1111111111 1111111111 1111111110 
1111111111 1111111111 1111111111 1111111111 1111111111 1111111111 1111111111 1111111112 
3111111111 1111111111 1111111111 1111111111 1111111111 1111111111 1111111111 1111111110 
1111111111 1111111111 1111111111 1111111111 1111111111 1111111111 1111111111 1111111112
3111111111 1111111111 1111111111 1111111111 1111111111 1111111111 1111111111 1111111110 
1111111111 1111111111 1111111111 1111111111 1111111111 1111111111 1111111111 1111111112
3111111111 1111111111 1111111111 1111111111 1111111111 1111111111 1111111111 1111111110 
1111111111 1111111111 1111111111 1111111111 1111111111 1111111111 1111111111 1111111112
3111111111 1111111111 1111111111 1111111111 1111111111 1111111111 1111111111 1111111110 
1111111111 1111111111 1111111111 1111111111 1111111111 1111111111 1111111111 1111111112
3111111111 1111111111 1111111111 1111111111 1111111111 1111111111 1111111111 1111111110 
1111111111 1111111111 1111111111 1111111111 1111111111 1111111111 1111111111 1111111112
3111111111 1111111111 1111111111 1111111111 1111111111 1111111111 1111111111 1111111110 
1111111111 1111111111 1111111111 1111111111 1111111111 1111111111 1111111111 1111111112
3111111111 1111111111 1111111111 1111111111 1111111111 1111111111 1111111111 1111111110 
1111111111 1111111111 1111111111 1111111111 1111111111 1111111111 1111111111 1111111112
3111111111 1111111111 1111111111 1111111111 1111111111 1111111111 1111111111 1111111110 
1111111111 1111111111 1111111111 1111111111 1111111111 1111111111 1111111111 1111111112
3111111111 1111111111 1111111111 1111111111 1111111111 1111111111 1111111111 1111111110 
1111111111 1111111111 1111111111 1111111111 1111111111 1111111111 1111111111 1111111112
3111111111 1111111111 1111111111 1111111111 1111111111 1111111111 1111111111 1111111110 
1111111111 1111111111 1111111111 1111111111 1111111111 1111111111 1111111111 1111111112
3111111111 1111111111 1111111111 1111111111 1111111111 1111111111 1111111111 1111111110 
1111111111 1111111111 1111111111 1111111111 1111111111 1111111111 1111111111 1111111112
3111111111 1111111111 1111111111 1111111111 1111111111 1111111111 1111111111 1111111110 
1111111111 1111111111 1111111111 1111111111 1111111111 1111111111 1111111111 1111111112
3111111111 1111111111 1111111111 1111111111 1111111111 1111111111 1111111111 1111111110 
1111111111 1111111111 1111111111 1111111111 1111111111 1111111111 1111111111 1111111112
3111111111 1111111111 1111111111 1111111111 1111111111 1111111111 1111111111 1111111110 
1111111111 1111111111 1111111111 1111111111 1111111111 1111111111 1111111111 1111111112
1111111111 1111111111 1111111111 1111111111 1111111111 1111111111 1111111111 1111111110

















































22222222222222222222222222222222222222222222313311123332222222222222222222222222
22222222222222222222222222222222222222222311131333322211111222222222222222222222
22222222222222222222222222222222211111333322222222222222311122211112222222222222
22222222222222222222222222222222111111112222222222222222222211111111122222222222
22222222222222222222222222222221111111112222222222222222222211111111122222222222
22222222222222222222222222222222221121113222222222222222222211111212222222222222
22222222222222222222222222222222223222111222222222222222222211222212222222222222
22222222222222222222222222222221222222313222222222222222222211222211222222222222
22222222222222222222222222222232222222212222222222222222222212222222132222222222
22222222222222222222222222222232222222222222222222222222222222222222313222222222
22222222222222222222222222222332222222222222222222222222222222222222211222222222
22222222222222222222222222223322222222222222222222222222222222222222222132222222
22222222222222222222222222212222222222222222222222222222222122222222222222222222
22222222222222222222222221111122222222222222222222222222111112222222222222222222
22222222222222222222222221111122222222222222222222222222111112222222222222222222
22222222222222222222222221111122222222222222222222222222111112222222222222222222
22222222222222222222222222111222222222222222222222222222211122222222222222222222
22222222222222222222222222222222222222222222222222222222222222222222222222222222
22222222222222222222222222222222222222222222222222222222222222222222222222223222
22222222222222222222222222222222222222222222222222222222222222222232222222231222
22222222222222222222222323222222222222222222222222222222222222222222322233111222
22222222222222222222223122222222222222222222222222222222222222222222222222231322
22222222222222222222223122222222222222222222222222222222222222222222222222211322
22222222222222222222223122222222222222222222222222222222222222222222222222231322
22222222222222222222223322222222222222222222222222222222222222222222222222231322
22222222222222222222223322222222222222222222222222222222222222222222222222211122
22222222222222222222222222222222222222222222222222222222222222222222222222231122
22222222222222222222222222222222222222222222222222222222222222222222222222231122
22222222222222222222222222222222222222222222222222222222222222222222222222231122
22222222222222222222222222222222222222222222222222222222222222222222221221231122
22222222222222222222223322222222222222222222222222222222222222222222223223221122
22222222222222222222221122222222222222222222222222222222222222222222222132321122
22222222222222222222221122221222222222222222222222222222222222222222222112131122
22222222222222222222221122221222222222222222222222222222222222222222222112131122
22222222222222222222223122221122222222222222222222222222222222222222231132311322
22222222222222222222222132223112222222222222222222222222222222222222211122311222
22222222222222222222222112222112222222222222222222222222222222222222211223211222
22222222222222222222222333222211222222222222222222222222222222222222111223311222
22222222222222222222222213222211122222222222222222222222222222222221112223313222
22222222222222222222222211222221112222222222222222222222222222222221132223112222
22222222222222222222222211122223111222222222222222222222222222222111122221112222
22222222222222222222222231122222211122222222222222222222222222221111222231122222
22222222222222222222222221122332221113222222222222222222222222111122222311122222
22222222222222222222222222113132222111112222222222222222222231111222222111222222
22222222222222222222222222111223122211111122222222222222222111122222232111222222
22222222222222222222222222211322222222111111111222222111111111222222231112222222
22222222222222222222222222211113222322223111111111111111111122222222311132222222
22222222222222222222222222221111222222222221111111111111122222222221111122222222
22222222222222222222222222222111332221112222222222222222222222222221111222222222
22222222222222222222222222222211113132222222222222222222222222222311112222222222
22222222222221222222222222222221111113222233222222222222222222231111122222222222
22222222222221322222222222222222311111133222222222222222222322111113222222222222
22222222222222211222222222222222221111113111111322222222311111111122222222222222
22222222222222212222222222222222222111111132233113333333111111112222222222222222
22222222222221222122222222222222222223111111111133311111111111122222222222222222
22222222222221222333222222222222222222211111111111111111111132222222222222222222
22222222222222222233122222222222222222222311111111111111132222222222222222222222
22222222222222112222112222222222222222222222222311111112222222222222222222222222
22222222222232111222211222222222222222222222222222222222222222222222222222222222
22222222222113221122221322222222222222222222222222222222222222222222222222222222
22222222221222221222221122222222222222222222222222222222222222222222222222222222
22222222112222222211222222222222222222222222222222222222222222222222222222222222
22222223222222222312222212222222222222222222222222222222222222222222222222222222
22222211222221212221322223122222222222222222222222222222222222222222222222222222
22222122222232111221122222122222222222222222222222222222222222222222222222222222
22222322222222111223112222222222222222222222222222222222222222222222222222222222
22222222222221212321113222222222222222222222222222222222222222222222222222222222
22222222222121312321331122122222222222211111222222211113222222222222222222222222
22222222222222111112211113222222222221111111112221111111122222222222222222222222
22222111111111222222221111322222222221122222112221122221112222222222222222222222
22222222211222222222222231122222222211222222112211222222111222222222222222222222
22222222222222222222222222222222222211222222222211232222222222222222222222222222
22222222222222222222222222222222222212222122222212222232122222222222222222222222
22222222222222222222222222222222222212222111111212222311111222222222222222222222
22222222222222222222222222222222222211222222212211222222212222222222222222222222
22222222222222222222222222222222222211222222211211222222212222222222222222222222
22222222222222222222222222222222222211122222212211122222212222222222222222222222
22222222222222222222222222222222222221111221112221112221112222222222222222222222
22222222222222222222222222222222222222121111222322111111222222222222222222222222
11111111111111111111111111111111111111111111111111111111111111111111111111111110




































31113231231232332332323332312311233123313131113131123113232323112333113313111312
31110312331333022213323013032132311102121131333223230323212332331122330233233312
33233313013302313322332333222312233333323132102212311322131323303321011213021230
11313122332330333223221101302313301022303133233122111333233323233023133113133332
32322313331012122232213311321132231301113222322311232322122330113333232313223022
22213331333111310212130131031223232232311303230131330210321331112130302313330330
32321103301123231321333313231113302133323030313213031033323332313311123121233012
33231111123230232303022132113311030312111223233313223101330213232323112311322322
13113123233032122323313303333123332113123033103033011323231311222301321313223310
33231213301331233302122112123323232322322312323222331303233323233111232121022232
22211323313311333123123333302331333213333123333302132113031222133123022313213232
13032333332231103331232312231023101311331102103321232333232221333211111112232230
32302222123023321213222113213131112313031121313232323310111032132231233313330232
11231322303132213033033233313333312123231232121123012133111223212213302230132212
32123212113211031333210213032232333222211133103101233211232302322333233303223310
11230122332313123121332232323323213233312323231231322113333310230110301321322132
31333210210113122331222322130111231103113332303323033113012323311232132103022302
13313332231322322332330210331111223313313010313033223321322222323111113113312322
33121301332222110122313311132332333232133312113213231012110222331332333110122230
13132311301010333311112132302221112303210133312323211330323021331301221123213332
30330232131232103032321210321313232121231213311303113213231331111232213211231230
23303231233123321222331332223033230333023310123331311321132231113023030233013132
13032311302332211331223133113123311330323313110223123232310133333101233013131222
30322123312303231333230322333210132303332233232233213331231223133123013122303222
33302301231131212223323103110232330122313321302231033233303111101113123301322132
31121331223111321110133333132310213121122123323213222130113132313233112133131222
31103012231312213332301130330231030303223212133122332333233222112311231130303122
11311113132310333033233123223011232311021322333330213013030323111033103231323222
33332322322331301302210332231232102111212103233011033333231113323322313303302122
32112333122303313313032231032333121112331130301333301322213123122330122333323212
21330103213121332233212103122101223323132312331210232321333101213332321321221122
32113231232331221312232321112323302131212232213032311032331123322101232231031332
21122132231333013123223232310212323211113013033130323133303112323132230331223102
23113133103331121222131112231323103233321232323333110302133312323131023303012332
33233121113333131211303321023013330211131022223330331311233330213223301233321032
13233303321323212132230311131130132123213212121331303232113031333021332133033112
32111030323101313323113233113323132333321122333211231330330332131132131113223230
31331123233312331023311131233021111210231111323231303232103101332332333133013112
12333323333133103102232333231211313311303232232323330122310331322132231121230310
32333033230333133111133221232123132123113222232212231323323332123232131123232312
33221130333321323323311331030331123221321331133333012123212101332331111133133330
33033211021132222122333013132233231211232233331223332331133233323223123133310332
21302313212303222302303310301231123033012223012212113311322122222102333101233322
33333330312112231132112131032323133133333213231322332133133223323230230323211230
22222213313121011233233112333230301133222130233330103113323301221311323333033332
30331032131112331022231321332303131322231233321023121322303332132312301330330132
11233301133113132313332233213232323322312223223321223023312103103123323012303222
33023113333233233330333303131330133323031103011031123232231310330310133121133322
31333231232221333303012321131031221130323233231212312221333032232323213112302222
11223111112323223331230231112323332333130313232121322232330301101331133230323030
33321123322133103212133011121232222223223110133232313210113033131231122333333232
22103113013210331311230323212213031030333312333021230232323303132132332223133332
13233121113323312331012213313330333233312232233223312113030123212332330321333012
33323333232212322303321332310113030313312111303012323333223222321111233312231130
33010212123031210322323232231130332312111133230333022212222113331323021122231332
23131113233103312131331021131123033033133322213111331033323113023302303221323022
23113131222323322332212331312333223322313023312313103123233230313322333323022330
22322332130122302311033031232331311332333213032121230310102312311331301213233332
21302213223222322131111332133232233222131333301233213131230321232232332310222212
23332312321213213103231033122303031222323223033332232311103013222321130123303110
32322111113322231323231211333332333330231333212233233032321322212231213223121132
33233233122230111030231111133302233332123012123012302311231033330223032333332332
10122221301132331213323333301233010223333231333233310113333212212133122233013332
33231223123233131322221121032210323231322233131310232313221312131331113221333302
23312232321121211131033323322331211231130121333032302110311122303231130133222322
21121310223231123311131013123012131132312332323233232313332333311011123102212122
13132332222303322131111130303230332330321123301310121310110122311131303130232302
32333232102231123223333323033312222232212330332232311111113132232331113112123110
21323113232131102231301103130232222323233023213233313323323211221331321322302332
31310333303223322111231233311302112333210333112333313333330231331213132131330102
31323103032231013232231013112331112301232103312333310132113232223121130332133232
23031113210223331011313333232103232332213310311222233123132232230303231101130230
13303122123313332331333210132323110331122131332122233123223213031322232331132312
33323132301323030211212331221333232113230313033213323130223332331330103233102122
31121210131213303323123011011332303131013033130232233232122113132123331322312332
31103123231032230323113113131301330313232330332122333131321233112332333133233322
13333231133301303132313130332111303321222311333101212331023131313330113112133132
33023213223112133323313123223233322331010111101231130132311212233211231313332322
21230122212313213010230303333030232231233311233133112322333313310332303331022222
11111101111111111111111111011111011011010111101101110110101110111010111011101010
