31111111111111111111111111111111111111111111111111111111111111111111111111111111
23111111111111111111111111111111111111111111111111111111111111111111111111111111
22311111111111111111111111111111111111111111111111111111111111111111111111111112
22231111111111111111111111111111111111111111111111111111111111111111111111111122
22223111111111111111111111111111111111111111111111111111111111111111111111111222
22222311111111111111111111111111111111111111111111111111111111111111111111112222
22222231111111111111111111111111111111111111111111111111111111111111111111122222
22222223111111111111111111111111111111111111111111111111111111111111111111222222
22222222311111111111111111111111111111111111111111111111111111111111111112222222
22222222231111111111111111111111111111111111111111111111111111111111111122222222
22222222223111111111111111111111111111111111111111111111111111111111111222222222
22222222222311111111111111111111111111111111111111111111111111111111112222222222
22222222222231111111111111111111111111111111111111111111111111111111122222222222
22222222222223111111111111111111111111111111111111111111111111111111222222222222
22222222222222311111111111111111111111111111111111111111111111111112222222222222
22222222222222231111111111111111111111111111111111111111111111111122222222222222
22222222222222223111111111111111111111111111111111111111111111111222222222222222
22222222222222222311111111111111111111111111111111111111111111112222222222222222
22222222222222222231111111111111111111111111111111111111111111122222222222222222
22222222222222222223111111111111111111111111111111111111111111222222222222222222
22222222222222222222311111111111111111111111111111111111111112222222222222222222
22222222222222222222231111111111111111111111111111111111111122222222222222222222
22222222222222222222223111111111111111111111111111111111111222222222222222222222
22222222222222222222222311111111111111111111111111111111112222222222222222222222
22222222222222222222222231111111111111111111111111111111122222222222222222222222
22222222222222222222222223111111111111111111111111111111222222222222222222222222
22222222222222222222222222311111111111111111111111111112222222222222222222222222
22222222222222222222222222231111111111111111111111111122222222222222222222222222
22222222222222222222222222223111111111111111111111111222222222222222222222222222
22222222222222222222222222222311111111111111111111112222222222222222222222222222
22222222222222222222222222222231111111111111111111122222222222222222222222222222
22222222222222222222222222222223111111111111111111222222222222222222222222222222
22222222222222222222222222222222311111111111111112222222222222222222222222222222
22222222222222222222222222222222231111111111111122222222222222222222222222222222
22222222222222222222222222222222223111111111111222222222222222222222222222222222
22222222222222222222222222222222222311111111112222222222222222222222222222222222
22222222222222222222222222222222222231111111122222222222222222222222222222222222
22222222222222222222222222222222222223111111222222222222222222222222222222222222
22222222222222222222222222222222222222311112222222222222222222222222222222222222
22222222222222222222222222222222222222231122222222222222222222222222222222222222
22222222222222222222222222222222222222221222222222222222222222222222222222222222
22222222222222222222222222222222222222211022222222222222222222222222222222222222
22222222222222222222222222222222222222111102222222222222222222222222222222222222
22222222222222222222222222222222222221111110222222222222222222222222222222222222
22222222222222222222222222222222222211111111022222222222222222222222222222222222
22222222222222222222222222222222222111111111102222222222222222222222222222222222
22222222222222222222222222222222221111111111110222222222222222222222222222222222
22222222222222222222222222222222211111111111111022222222222222222222222222222222
22222222222222222222222222222222111111111111111102222222222222222222222222222222
22222222222222222222222222222221111111111111111110222222222222222222222222222222
22222222222222222222222222222211111111111111111111022222222222222222222222222222
22222222222222222222222222222111111111111111111111102222222222222222222222222222
22222222222222222222222222221111111111111111111111110222222222222222222222222222
22222222222222222222222222211111111111111111111111111022222222222222222222222222
22222222222222222222222222111111111111111111111111111102222222222222222222222222
22222222222222222222222221111111111111111111111111111110222222222222222222222222
22222222222222222222222211111111111111111111111111111111022222222222222222222222
22222222222222222222222111111111111111111111111111111111102222222222222222222222
22222222222222222222221111111111111111111111111111111111110222222222222222222222
22222222222222222222211111111111111111111111111111111111111022222222222222222222
22222222222222222222111111111111111111111111111111111111111102222222222222222222
22222222222222222221111111111111111111111111111111111111111110222222222222222222
22222222222222222211111111111111111111111111111111111111111111022222222222222222
22222222222222222111111111111111111111111111111111111111111111102222222222222222
22222222222222221111111111111111111111111111111111111111111111110222222222222222
22222222222222211111111111111111111111111111111111111111111111111022222222222222
22222222222222111111111111111111111111111111111111111111111111111102222222222222
22222222222221111111111111111111111111111111111111111111111111111110222222222222
22222222222211111111111111111111111111111111111111111111111111111111022222222222
22222222222111111111111111111111111111111111111111111111111111111111102222222222
22222222221111111111111111111111111111111111111111111111111111111111110222222222
22222222211111111111111111111111111111111111111111111111111111111111111022222222
22222222111111111111111111111111111111111111111111111111111111111111111102222222
22222221111111111111111111111111111111111111111111111111111111111111111110222222
22222211111111111111111111111111111111111111111111111111111111111111111111022222
22222111111111111111111111111111111111111111111111111111111111111111111111102222
22221111111111111111111111111111111111111111111111111111111111111111111111110222
22211111111111111111111111111111111111111111111111111111111111111111111111111022
22111111111111111111111111111111111111111111111111111111111111111111111111111102
21111111111111111111111111111111111111111111111111111111111111111111111111111110
